###############
#      #    S##
# ### ### ### #
#   #     #   #
### # ####### #
#   #   #     #
# ### ### ### #
#   #   #   # #
### # ### # # #
#   #     # # #
# ##### ### ###
#     #     # #
##### ### ### #
#            E#
###############