##################################################
#S    #       #     #       #                    #
# # ### ### # ### # ##### ### ####################
# # #   #   #   # #     #       #       #        #
# # # ### ##### # ##### # ####### ##### # ########
# #     # #   # # #   # #   #     #   #   #   #  #
# ####### # ### # # # # ##### ##### ######### # ##
#       # # #   # # #   #     #     #         #  #
####### # # # ### # ##### ######### # ##### ######
#     # # #       # #   #   #     #   #   #   #  #
# ### # # ######### # # ### ### # ##### # ### # ##
#   # # #         #   #     #   #   #   #     #  #
### # # # ####### ########### ##### # ####### ####
# # #   # #     # #         #     #   #       #  #
# # ##### ### ### # ##### # # ### ##### #######  # 
#   #     #   #   # #   # # # # #     #          # 
# ### ##### # # ##### # # ### # ##### ####### ####
# #     #   # #       # # #   #   # #     #   #  #
# ##### # # ########### # # ### # # ##### ##### ##
#   #   # #     #       #   #     #     #     #  #
# ### ### ### # ##### ##### ######### # ### ### ##
# # #     #   #     # #     #       # # #   #    # 
# # # ##### ####### # ### ### ##### # # # # # #  # 
# #     #       #   #   # #   #     #   # #   #  # 
# ########### ### ##### # ##### ####### #######  # 
#   #         #   #   # #   # #     #     #      # 
### # ######### ### # ### # # ### # ### ### ###  # 
#   #   #         # #     #     # #   #   # #    # 
# ### # # ####### # ######### ### ### # # # # #  # 
#   # # #       #   #       # #     # # # # # #  # 
# # # # ##### # ### # ##### # # ### ### # # # #  # 
# # #   #   # #     # #   #   #   #     # #   #  # 
# # ##### # ####### # # # ####### ##### # #####  # 
# #   #   #       #   # #       #   #   #        # 
# ### # ######### ### ### ##### ### # #########  # 
#     #     #     #     #   #     #   #   #   #  # 
### ##### # # ##### ### ### ### ### ### # # # #  # 
#     #   #   #     #   # #     # #     # # #    # 
# ### # ####### ##### # # ##### # ####### # ######
# # # #       #     # #     #     #     # #      # 
# # # ####### # ### # ##### ####### ### # ### ####
#   #       # #   # #     # #     #   # #     #  # 
##### ##### # ### # ### # # # ### ### # # ### #  # 
#   #     #     # #   # #   #   #     # # #   #  # 
# # ##### ##### # ### ##### ### ### # # # # ###  # 
# #   #     #   # #     #   #   #   # #   #   #  # 
# ### # ### # ### # ### ### # ### ### ####### #  # 
#     #   # # #   # #     # #   # #   #       #  # 
# ##### ### # # ### # ##### # # # # ##### ######## 
#     #     # #     #     #   #   #     #       E# 
##################################################