#################
#S        #     #
##### # # ### ###
#   # # # #     #
# # ### ### ### #
# # # # # # #   #
# # # # ### # # #
# # # # #   # # #
# ##### ####### #
#   #         # #
### ####### #####
# #       #     #
# ############# #
#     #       E #
#################