###############################
#S#           #         #     #
# ### ####### # ####### # # # #
#     #   #   # #     # # # # #
####### # # ### # ### ### # # #
#       # #   #     #     # # #
##### ### ### ##### ####### # #
#     # #   #   #   #   #   # #
# ##### ### ### ##### # # ### #
# # #     # # # #     # # #   #
# # # ### # # # # ##### # # ###
# #   #   #   #   #   # # #   #
# # ### ##### ##### # # # #####
# #   #         #   # # #     #
# ####### ##### ### ### # ### #
# #     # #   #   # #   # #   #
# # ### ### # ### # # ##### # #
#   #   #   #   #   #       # #
##### ### ##### ############# #
#   # #   #   #             # #
# # # # ##### ######### ##### #
# #   #     #         # #     #
# ######### # ##### # # # #####
# #     #   #   #   # # # #   #
# # # # # ##### # ### # # # # #
# # # # #   #   #   # #   # # #
# # # ##### ##### # # ##### # #
# # #     #     # # # #     # #
# # ### ####### ### # # ##### #
#     #             #   #    E#
###############################