##################################################
#S..  #.....  #     #       #                    #
# #.###.###.# ### # ##### ### ####################
# #.#...#...#   # #     #       #       #        #
# #.#.###.##### # ##### # ####### ##### # ########
# #...  #.#   # # #   # #   #     #   #   #   #  #
# #######.# ### # # # # ##### ##### ######### # ##
#       #.# #   # # #   #     #     #         #  #
####### #.# # ### # ##### ######### # ##### ######
#     # #.#       # #   #   #     #   #   #   #  #
# ### # #.######### # # ### ### # ##### # ### # ##
#   # # #.        #   #     #   #   #   #     #  #
### # # #.####### ########### ##### # ####### ####
# # #   #.#     # #         #     #   #       #  #
# # #####.### ### # ##### # # ### ##### #######  # 
#   #.....#   #   # #   # # # # #     #          # 
# ###.##### # # ##### # # ### # ##### ####### ####
# #  ...#...# #       # # #   #   # #     #   #  #
# #####.#.#.########### # # ### # # ##### ##### ##
#   #...#.#.....#       #   #     #     #     #  #
# ###.###.### #.##### ##### ######### # ### ### ##
# # #.....#   #.....# #     #       # # #   #    # 
# # # ##### #######.# ### ### ##### # # # # # #  # 
# #     #       #...#   # #   #     #   # #   #  # 
# ########### ###.##### # ##### ####### #######  # 
#   #         #...#   # #   # #     #     #      # 
### # #########.### # ### # # ### # ### ### ###  # 
#   #   #      ...# #     #     # #   #   # #    # 
# ### # # #######.# ######### ### ### # # # # #  # 
#   # # #       #...#       # #     # # # # # #  # 
# # # # ##### # ###.# ##### # # ### ### # # # #  # 
# # #   #   # #    .# #   #   #   #     # #   #  # 
# # ##### # #######.# # # ####### ##### # #####  # 
# #   #   #       #...# #       #   #   #        # 
# ### # ######### ###.### ##### ### # #########  # 
#     #     #     #  ...#   #     #   #   #   #  # 
### ##### # # ##### ###.### ### ### ### # # # #  # 
#     #   #   #     #  .# #     # #     # # #    # 
# ### # ####### ##### #.# ##### # ####### # ######
# # # #       #     # #.....#     #.....# #      # 
# # # ####### # ### # #####.#######.###.# ### ####
#   #       # #   # #     #.#     #...#.#.....#  # 
##### ##### # ### # ### # #.# ### ###.#.#.###.#  # 
#   #     #     # #   # #  .#   #  ...#.#.#...#  # 
# # ##### ##### # ### #####.### ###.# #.#.#.###  # 
# #   #     #   # #     #  .#   #...# #...#...#  # 
# ### # ### # ### # ### ###.# ###.### #######.#  # 
#     #   # # #   # #     #.#...#.#   #  .....#  # 
# ##### ### # # ### # #####.#.#.#.# #####.######## 
#     #     # #     #     #...#...#     #.......E# 
##################################################
