###############
#      # ...S##
# ### ###.### #
#   #.....#   #
### #.####### #
#   #.  #     #
# ###.### ### #
#   #.  #   # #
### #.### # # #
#   #...  # # #
# #####.### ###
#     #...  # #
##### ###.### #
#        ....E#
###############
