{
  "caminho": [
    {"x": 1, "y": 2},
    {"x": 1, "y": 3},
    {"x": 2, "y": 3},
    {"x": 3, "y": 3},
    {"x": 4, "y": 3},
    {"x": 5, "y": 3},
    {"x": 5, "y": 4},
    {"x": 5, "y": 5},
    {"x": 4, "y": 5},
    {"x": 3, "y": 5},
    {"x": 3, "y": 6},
    {"x": 3, "y": 7},
    {"x": 2, "y": 7},
    {"x": 1, "y": 7},
    {"x": 1, "y": 8},
    {"x": 1, "y": 9},
    {"x": 1, "y": 10},
    {"x": 1, "y": 11},
    {"x": 2, "y": 11},
    {"x": 3, "y": 11},
    {"x": 3, "y": 10},
    {"x": 3, "y": 9},
    {"x": 4, "y": 9},
    {"x": 5, "y": 9},
    {"x": 6, "y": 9},
    {"x": 7, "y": 9},
    {"x": 8, "y": 9},
    {"x": 9, "y": 9},
    {"x": 10, "y": 9},
    {"x": 11, "y": 9},
    {"x": 12, "y": 9},
    {"x": 13, "y": 9},
    {"x": 14, "y": 9},
    {"x": 15, "y": 9},
    {"x": 15, "y": 8},
    {"x": 15, "y": 7},
    {"x": 15, "y": 6},
    {"x": 15, "y": 5},
    {"x": 16, "y": 5},
    {"x": 17, "y": 5},
    {"x": 17, "y": 6},
    {"x": 17, "y": 7},
    {"x": 18, "y": 7},
    {"x": 19, "y": 7},
    {"x": 19, "y": 6},
    {"x": 19, "y": 5},
    {"x": 20, "y": 5},
    {"x": 21, "y": 5},
    {"x": 21, "y": 6},
    {"x": 21, "y": 7},
    {"x": 21, "y": 8},
    {"x": 21, "y": 9},
    {"x": 20, "y": 9},
    {"x": 19, "y": 9},
    {"x": 18, "y": 9},
    {"x": 17, "y": 9},
    {"x": 17, "y": 10},
    {"x": 17, "y": 11},
    {"x": 18, "y": 11},
    {"x": 19, "y": 11},
    {"x": 19, "y": 12},
    {"x": 19, "y": 13},
    {"x": 19, "y": 14},
    {"x": 19, "y": 15},
    {"x": 20, "y": 15},
    {"x": 21, "y": 15},
    {"x": 21, "y": 16},
    {"x": 21, "y": 17},
    {"x": 21, "y": 18},
    {"x": 21, "y": 19},
    {"x": 22, "y": 19},
    {"x": 23, "y": 19},
    {"x": 23, "y": 18},
    {"x": 23, "y": 17},
    {"x": 24, "y": 17},
    {"x": 25, "y": 17},
    {"x": 25, "y": 16},
    {"x": 25, "y": 15},
    {"x": 26, "y": 15},
    {"x": 27, "y": 15},
    {"x": 27, "y": 16},
    {"x": 27, "y": 17},
    {"x": 28, "y": 17},
    {"x": 29, "y": 17},
    {"x": 29, "y": 18},
    {"x": 29, "y": 19},
    {"x": 30, "y": 19},
    {"x": 31, "y": 19},
    {"x": 32, "y": 19},
    {"x": 33, "y": 19},
    {"x": 33, "y": 20},
    {"x": 33, "y": 21},
    {"x": 34, "y": 21},
    {"x": 35, "y": 21},
    {"x": 35, "y": 22},
    {"x": 35, "y": 23},
    {"x": 36, "y": 23},
    {"x": 37, "y": 23},
    {"x": 38, "y": 23},
    {"x": 39, "y": 23},
    {"x": 39, "y": 24},
    {"x": 39, "y": 25},
    {"x": 39, "y": 26},
    {"x": 39, "y": 27},
    {"x": 40, "y": 27},
    {"x": 41, "y": 27},
    {"x": 42, "y": 27},
    {"x": 43, "y": 27},
    {"x": 44, "y": 27},
    {"x": 45, "y": 27},
    {"x": 46, "y": 27},
    {"x": 47, "y": 27},
    {"x": 48, "y": 27},
    {"x": 49, "y": 27},
    {"x": 49, "y": 28},
    {"x": 49, "y": 29},
    {"x": 48, "y": 29},
    {"x": 47, "y": 29},
    {"x": 47, "y": 30},
    {"x": 47, "y": 31},
    {"x": 48, "y": 31},
    {"x": 49, "y": 31},
    {"x": 49, "y": 32},
    {"x": 49, "y": 33},
    {"x": 48, "y": 33},
    {"x": 47, "y": 33},
    {"x": 46, "y": 33},
    {"x": 45, "y": 33},
    {"x": 45, "y": 34},
    {"x": 45, "y": 35},
    {"x": 44, "y": 35},
    {"x": 43, "y": 35},
    {"x": 43, "y": 36},
    {"x": 43, "y": 37},
    {"x": 42, "y": 37},
    {"x": 41, "y": 37},
    {"x": 41, "y": 36},
    {"x": 41, "y": 35},
    {"x": 40, "y": 35},
    {"x": 39, "y": 35},
    {"x": 39, "y": 36},
    {"x": 39, "y": 37},
    {"x": 39, "y": 38},
    {"x": 39, "y": 39},
    {"x": 40, "y": 39},
    {"x": 41, "y": 39},
    {"x": 42, "y": 39},
    {"x": 43, "y": 39},
    {"x": 44, "y": 39},
    {"x": 45, "y": 39},
    {"x": 45, "y": 40},
    {"x": 45, "y": 41},
    {"x": 44, "y": 41},
    {"x": 43, "y": 41},
    {"x": 42, "y": 41},
    {"x": 41, "y": 41},
    {"x": 41, "y": 42},
    {"x": 41, "y": 43},
    {"x": 41, "y": 44},
    {"x": 41, "y": 45},
    {"x": 42, "y": 45},
    {"x": 43, "y": 45},
    {"x": 43, "y": 44},
    {"x": 43, "y": 43},
    {"x": 44, "y": 43},
    {"x": 45, "y": 43},
    {"x": 45, "y": 44},
    {"x": 45, "y": 45},
    {"x": 46, "y": 45},
    {"x": 47, "y": 45},
    {"x": 47, "y": 44},
    {"x": 47, "y": 43},
    {"x": 47, "y": 42},
    {"x": 47, "y": 41},
    {"x": 48, "y": 41},
    {"x": 49, "y": 41},
    {"x": 49, "y": 42},
    {"x": 49, "y": 43},
    {"x": 49, "y": 44},
    {"x": 49, "y": 45},
    {"x": 49, "y": 46},
    {"x": 49, "y": 47},
    {"x": 49, "y": 48}
  ]
}
