#################
#S......  #     #
##### #.# ### ###
#   # #.# #     #
# # ###.### ### #
# # # #.# # #   #
# # # #.### # # #
# # # #.#   # # #
# #####.####### #
#   #  .....  # #
### #######.#####
# #       #.....#
# #############.#
#     #       E.#
#################
