#################
#S....#   #     #
#####.### # ### #
#   #...# # # # #
# # ###.# # # # #
# # # #.#     # #
# # # #.# ##### #
# #   #.# # #   #
# #####.# # # ###
#.......#   #   #
#.######### ### #
#.#           # #
#.############# #
#.............# #
#############.# #
#            ..E#
#################
