{
  "caminho": [
    {"x": 2, "y": 1},
    {"x": 3, "y": 1},
    {"x": 3, "y": 2},
    {"x": 3, "y": 3},
    {"x": 3, "y": 4},
    {"x": 3, "y": 5},
    {"x": 2, "y": 5},
    {"x": 1, "y": 5},
    {"x": 1, "y": 6},
    {"x": 1, "y": 7},
    {"x": 1, "y": 8},
    {"x": 1, "y": 9},
    {"x": 1, "y": 10},
    {"x": 1, "y": 11},
    {"x": 1, "y": 12},
    {"x": 1, "y": 13},
    {"x": 2, "y": 13},
    {"x": 3, "y": 13},
    {"x": 3, "y": 12},
    {"x": 3, "y": 11},
    {"x": 4, "y": 11},
    {"x": 5, "y": 11},
    {"x": 5, "y": 12},
    {"x": 5, "y": 13},
    {"x": 6, "y": 13},
    {"x": 7, "y": 13},
    {"x": 7, "y": 14},
    {"x": 7, "y": 15},
    {"x": 8, "y": 15},
    {"x": 9, "y": 15},
    {"x": 10, "y": 15},
    {"x": 11, "y": 15},
    {"x": 11, "y": 16},
    {"x": 11, "y": 17},
    {"x": 10, "y": 17},
    {"x": 9, "y": 17},
    {"x": 9, "y": 18},
    {"x": 9, "y": 19},
    {"x": 9, "y": 20},
    {"x": 9, "y": 21},
    {"x": 8, "y": 21},
    {"x": 7, "y": 21},
    {"x": 7, "y": 22},
    {"x": 7, "y": 23},
    {"x": 8, "y": 23},
    {"x": 9, "y": 23},
    {"x": 10, "y": 23},
    {"x": 11, "y": 23},
    {"x": 12, "y": 23},
    {"x": 13, "y": 23},
    {"x": 14, "y": 23},
    {"x": 15, "y": 23},
    {"x": 15, "y": 22},
    {"x": 15, "y": 21},
    {"x": 16, "y": 21},
    {"x": 17, "y": 21},
    {"x": 17, "y": 22},
    {"x": 17, "y": 23},
    {"x": 17, "y": 24},
    {"x": 17, "y": 25},
    {"x": 17, "y": 26},
    {"x": 17, "y": 27},
    {"x": 16, "y": 27},
    {"x": 15, "y": 27},
    {"x": 15, "y": 28},
    {"x": 15, "y": 29},
    {"x": 16, "y": 29},
    {"x": 17, "y": 29},
    {"x": 18, "y": 29},
    {"x": 19, "y": 29},
    {"x": 20, "y": 29},
    {"x": 21, "y": 29},
    {"x": 21, "y": 28},
    {"x": 21, "y": 27},
    {"x": 21, "y": 26},
    {"x": 21, "y": 25},
    {"x": 22, "y": 25},
    {"x": 23, "y": 25},
    {"x": 24, "y": 25},
    {"x": 25, "y": 25},
    {"x": 25, "y": 24},
    {"x": 25, "y": 23},
    {"x": 24, "y": 23},
    {"x": 23, "y": 23},
    {"x": 22, "y": 23},
    {"x": 21, "y": 23},
    {"x": 20, "y": 23},
    {"x": 19, "y": 23},
    {"x": 19, "y": 22},
    {"x": 19, "y": 21},
    {"x": 19, "y": 20},
    {"x": 19, "y": 19},
    {"x": 19, "y": 18},
    {"x": 19, "y": 17},
    {"x": 19, "y": 16},
    {"x": 19, "y": 15},
    {"x": 18, "y": 15},
    {"x": 17, "y": 15},
    {"x": 17, "y": 14},
    {"x": 17, "y": 13},
    {"x": 16, "y": 13},
    {"x": 15, "y": 13},
    {"x": 15, "y": 12},
    {"x": 15, "y": 11},
    {"x": 16, "y": 11},
    {"x": 17, "y": 11},
    {"x": 17, "y": 10},
    {"x": 17, "y": 9},
    {"x": 18, "y": 9},
    {"x": 19, "y": 9},
    {"x": 19, "y": 8},
    {"x": 19, "y": 7},
    {"x": 20, "y": 7},
    {"x": 21, "y": 7},
    {"x": 21, "y": 8},
    {"x": 21, "y": 9},
    {"x": 21, "y": 10},
    {"x": 21, "y": 11},
    {"x": 22, "y": 11},
    {"x": 23, "y": 11},
    {"x": 23, "y": 10},
    {"x": 23, "y": 9},
    {"x": 24, "y": 9},
    {"x": 25, "y": 9},
    {"x": 25, "y": 10},
    {"x": 25, "y": 11},
    {"x": 26, "y": 11},
    {"x": 27, "y": 11},
    {"x": 27, "y": 12},
    {"x": 27, "y": 13},
    {"x": 27, "y": 14},
    {"x": 27, "y": 15},
    {"x": 28, "y": 15},
    {"x": 29, "y": 15},
    {"x": 29, "y": 16},
    {"x": 29, "y": 17},
    {"x": 29, "y": 18},
    {"x": 29, "y": 19},
    {"x": 28, "y": 19},
    {"x": 27, "y": 19},
    {"x": 26, "y": 19},
    {"x": 25, "y": 19},
    {"x": 25, "y": 18},
    {"x": 25, "y": 17},
    {"x": 24, "y": 17},
    {"x": 23, "y": 17},
    {"x": 23, "y": 18},
    {"x": 23, "y": 19},
    {"x": 22, "y": 19},
    {"x": 21, "y": 19},
    {"x": 21, "y": 20},
    {"x": 21, "y": 21},
    {"x": 22, "y": 21},
    {"x": 23, "y": 21},
    {"x": 24, "y": 21},
    {"x": 25, "y": 21},
    {"x": 26, "y": 21},
    {"x": 27, "y": 21},
    {"x": 28, "y": 21},
    {"x": 29, "y": 21},
    {"x": 29, "y": 22},
    {"x": 29, "y": 23},
    {"x": 28, "y": 23},
    {"x": 27, "y": 23},
    {"x": 27, "y": 24},
    {"x": 27, "y": 25},
    {"x": 27, "y": 26},
    {"x": 27, "y": 27},
    {"x": 26, "y": 27},
    {"x": 25, "y": 27},
    {"x": 24, "y": 27},
    {"x": 23, "y": 27},
    {"x": 23, "y": 28},
    {"x": 23, "y": 29},
    {"x": 24, "y": 29},
    {"x": 25, "y": 29},
    {"x": 26, "y": 29},
    {"x": 27, "y": 29},
    {"x": 28, "y": 29},
    {"x": 29, "y": 29}
  ]
}
