###############################
#S#  .........#         #     #
#.###.#######.# ####### # # # #
#.....#   #...# #     # # # # #
####### # #.### # ### ### # # #
#       # #...#     #     # # #
##### ### ###.##### ####### # #
#     # #   #...#   #...#   # #
# ##### ### ###.#####.#.# ### #
# # #     # # #.#.....#.# #   #
# # # ### # # #.#.#####.# # ###
# #   #   #   #...#   #.# #   #
# # ### ##### ##### # #.# #####
# #   #         #   # #.#     #
# ####### ##### ### ###.# ### #
# #     # #...#   # #...# #...#
# # ### ###.#.### # #.#####.#.#
#   #   #...#...#   #.......#.#
##### ###.#####.#############.#
#   # #...#   #.........    #.#
# # # #.##### #########.#####.#
# #   #.....#      ...#.#.....#
# #########.# #####.#.#.#.#####
# #     #...#   #...#.#.#.#...#
# # # # #.##### #.###.#.#.#.#.#
# # # # #...#   #...#.#...#.#.#
# # # #####.##### #.#.#####.#.#
# # #     #.....# #.#.#.....#.#
# # ### #######.###.#.#.#####.#
#     #        .....#...#    E#
###############################
